"Occupation","State","BirthCitizen","Immigrant","medianWage","totalPop","Immigrant_Prop","OccName"
10,"DC",5228,482,100000,5710,8,"Chief executives"
10,"MD",12274,2236,120000,14510,15,"Chief executives"
10,"VA",18957,3215,125000,22172,14,"Chief executives"
20,"DC",1954,216,67000,2170,9,"General and operations managers"
20,"MD",6438,1828,70000,8266,22,"General and operations managers"
20,"VA",8635,2368,71000,11003,21,"General and operations managers"
50,"DC",2547,161,70000,2708,5,"Marketing and sales managers"
50,"MD",7126,1110,60000,8236,13,"Marketing and sales managers"
50,"VA",11389,1885,82000,13274,14,"Marketing and sales managers"
60,"DC",2193,347,85000,2540,13,"Public relations and fundraising managers"
60,"MD",2273,197,110000,2470,7,"Public relations and fundraising managers"
60,"VA",1980,1141,80000,3121,36,"Public relations and fundraising managers"
100,"MD",2251,0,75000,2251,0,"Administrative services managers"
100,"VA",2067,556,80000,2623,21,"Administrative services managers"
110,"DC",1652,658,105000,2310,28,"Computer and information systems managers"
110,"MD",9583,2551,109000,12134,21,"Computer and information systems managers"
110,"VA",15170,3648,110000,18818,19,"Computer and information systems managers"
120,"DC",3230,577,97000,3807,15,"Financial managers"
120,"MD",9969,3702,80000,13671,27,"Financial managers"
120,"VA",12552,5750,95000,18302,31,"Financial managers"
136,"MD",4854,964,74000,5818,16,"Human resources managers"
136,"VA",7463,1741,97000,9204,18,"Human resources managers"
150,"MD",3780,1061,85000,4841,21,"Purchasing managers"
150,"VA",6022,679,105000,6701,10,"Purchasing managers"
160,"MD",3024,346,45000,3370,10,"Transportation, storage, and distribution managers"
160,"VA",2184,393,60000,2577,15,"Transportation, storage, and distribution managers"
205,"VA",2368,437,840,2805,15,"Farmers, ranchers, and other agricultural managers"
220,"MD",5937,1131,50000,7068,16,"Construction managers"
220,"VA",6957,2039,70000,8996,22,"Construction managers"
230,"DC",3536,186,66000,3722,4,"Education administrators"
230,"MD",9338,1381,64000,10719,12,"Education administrators"
230,"VA",10176,2144,63000,12320,17,"Education administrators"
300,"VA",2547,254,143000,2801,9,"Architectural and engineering managers"
310,"MD",4609,3828,35000,8437,45,"Food service managers"
310,"VA",7594,7266,34000,14860,48,"Food service managers"
350,"DC",1871,455,95000,2326,19,"Medical and health services managers"
350,"MD",5575,2070,86000,7645,27,"Medical and health services managers"
350,"VA",4327,1083,65000,5410,20,"Medical and health services managers"
410,"MD",3957,778,57000,4735,16,"Property, real estate, and community association managers"
410,"VA",5971,2114,59000,8085,26,"Property, real estate, and community association managers"
420,"DC",5956,469,80000,6425,7,"Social and community service managers"
420,"MD",6129,373,50000,6502,5,"Social and community service managers"
420,"VA",8333,1325,65000,9658,13,"Social and community service managers"
430,"DC",20165,4622,89000,24787,18,"Managers, all other"
430,"MD",57594,15565,90000,73159,21,"Managers, all other"
430,"VA",84307,20890,100000,105197,19,"Managers, all other"
530,"MD",3678,272,82000,3950,6,"Purchasing agents, except wholesale, retail, and farm products"
530,"VA",3860,1269,91000,5129,24,"Purchasing agents, except wholesale, retail, and farm products"
540,"MD",1887,351,50000,2238,15,"Claims adjusters, appraisers, examiners, and investigators"
540,"VA",2684,581,65000,3265,17,"Claims adjusters, appraisers, examiners, and investigators"
565,"MD",3255,588,81000,3843,15,"Compliance officers"
565,"VA",3207,647,110000,3854,16,"Compliance officers"
600,"VA",1691,672,40000,2363,28,"Cost estimators"
630,"DC",3076,261,57000,3337,7,"Human resources workers"
630,"MD",10192,1122,78000,11314,9,"Human resources workers"
630,"VA",15809,3112,72000,18921,16,"Human resources workers"
640,"MD",1621,390,70000,2011,19,"Compensation, benefits, and job analysis specialists"
650,"VA",2576,317,87000,2893,10,"Training and development specialists"
700,"MD",1820,602,65000,2422,24,"Logisticians"
700,"VA",3674,325,45000,3999,8,"Logisticians"
710,"DC",7900,1258,85000,9158,13,"Management analysts"
710,"MD",15410,3984,72000,19394,20,"Management analysts"
710,"VA",27664,7411,80000,35075,21,"Management analysts"
725,"MD",3858,709,42000,4567,15,"Meeting, convention, and event planners"
725,"VA",2610,916,35000,3526,25,"Meeting, convention, and event planners"
726,"VA",1842,377,38000,2219,16,"Fundraisers"
735,"VA",3508,54,45000,3562,1,"Market research analysts and marketing specialists"
740,"DC",4105,558,65000,4663,11,"Business operations specialists, all other"
740,"MD",5599,1291,65000,6890,18,"Business operations specialists, all other"
740,"VA",6605,2719,78000,9324,29,"Business operations specialists, all other"
800,"DC",3316,456,80000,3772,12,"Accountants and auditors"
800,"MD",25143,9312,60000,34455,27,"Accountants and auditors"
800,"VA",25419,12027,68000,37446,32,"Accountants and auditors"
820,"MD",2476,431,89000,2907,14,"Budget analysts"
820,"VA",2980,500,98000,3480,14,"Budget analysts"
840,"MD",3404,1116,62000,4520,24,"Financial analysts"
840,"VA",4653,1749,79000,6402,27,"Financial analysts"
850,"MD",2732,675,120000,3407,19,"Personal financial advisors"
850,"VA",4432,628,44000,5060,12,"Personal financial advisors"
910,"MD",2727,394,65000,3121,12,"Credit counselors and loan officers"
910,"VA",4685,919,60000,5604,16,"Credit counselors and loan officers"
1006,"DC",2101,407,65000,2508,16,"Computer systems analysts"
1006,"MD",7303,1904,70000,9207,20,"Computer systems analysts"
1006,"VA",14642,6317,80000,20959,30,"Computer systems analysts"
1007,"MD",2192,245,76000,2437,10,"Information security analysts"
1007,"VA",3919,255,103000,4174,6,"Information security analysts"
1010,"MD",6163,1987,86000,8150,24,"Computer programmers"
1010,"VA",4487,3294,85000,7781,42,"Computer programmers"
1020,"DC",4073,454,90000,4527,10,"Software developers, applications and systems software"
1020,"MD",15573,5329,100000,20902,25,"Software developers, applications and systems software"
1020,"VA",31820,15658,102000,47478,32,"Software developers, applications and systems software"
1030,"VA",3034,1443,68000,4477,32,"Web developers"
1050,"DC",2133,401,64000,2534,15,"Computer support specialists"
1050,"MD",9622,1774,67000,11396,15,"Computer support specialists"
1050,"VA",10017,5265,70000,15282,34,"Computer support specialists"
1060,"VA",2769,1560,94000,4329,36,"Database administrators"
1105,"MD",4294,595,80000,4889,12,"Network and computer systems administrators"
1105,"VA",4276,2327,85000,6603,35,"Network and computer systems administrators"
1106,"MD",1673,926,98000,2599,35,"Computer network architects "
1106,"VA",3253,1445,120000,4698,30,"Computer network architects "
1107,"DC",2532,97,65000,2629,3,"Computer occupations, all other"
1107,"MD",10281,2257,70000,12538,18,"Computer occupations, all other"
1107,"VA",10654,6654,85000,17308,38,"Computer occupations, all other"
1220,"DC",5388,1072,78000,6460,16,"Operations research analysts"
1220,"MD",6078,1255,92000,7333,17,"Operations research analysts"
1220,"VA",13816,1172,100000,14988,7,"Operations research analysts"
1240,"MD",2025,938,92000,2963,31,"Miscellaneous mathematical science occupations"
1240,"VA",2152,631,86000,2783,22,"Miscellaneous mathematical science occupations"
1300,"MD",2211,1135,75000,3346,33,"Architects, except naval"
1300,"VA",3349,629,70000,3978,15,"Architects, except naval"
1360,"MD",3563,2037,88000,5600,36,"Civil engineers"
1360,"VA",3798,1361,100000,5159,26,"Civil engineers"
1410,"MD",1979,876,105000,2855,30,"Electrical and electronics engineers"
1410,"VA",1912,796,105000,2708,29,"Electrical and electronics engineers"
1460,"VA",1325,989,90000,2314,42,"Mechanical engineers"
1530,"MD",7719,2530,110000,10249,24,"Engineers, all other"
1530,"VA",10832,3902,112000,14734,26,"Engineers, all other"
1550,"MD",4175,880,45000,5055,17,"Engineering technicians, except drafters"
1550,"VA",2230,1008,68000,3238,31,"Engineering technicians, except drafters"
1610,"MD",1392,914,90000,2306,39,"Biological scientists"
1610,"VA",1539,497,60000,2036,24,"Biological scientists"
1650,"MD",3467,4769,94000,8236,57,"Medical scientists"
1760,"DC",1731,1697,76000,3428,49,"Physical scientists, all other"
1760,"MD",4951,4602,93000,9553,48,"Physical scientists, all other"
1760,"VA",3613,933,76000,4546,20,"Physical scientists, all other"
1800,"DC",1716,1165,110000,2881,40,"Economists"
1800,"MD",1557,1256,102000,2813,44,"Economists"
1800,"VA",1565,1406,116000,2971,47,"Economists"
1820,"VA",2283,300,15000,2583,11,"Psychologists"
1860,"VA",2657,737,100000,3394,21,"Miscellaneous social scientists and related workers"
1965,"DC",1353,837,8000,2190,38,"Miscellaneous life, physical, and social science technicians"
1965,"MD",3534,1840,15000,5374,34,"Miscellaneous life, physical, and social science technicians"
1965,"VA",2201,173,35400,2374,7,"Miscellaneous life, physical, and social science technicians"
2000,"DC",2496,380,40000,2876,13,"Counselors"
2000,"MD",9750,2405,30000,12155,19,"Counselors"
2000,"VA",8069,1636,43000,9705,16,"Counselors"
2010,"DC",2971,117,47000,3088,3,"Social workers"
2010,"MD",8276,1107,46000,9383,11,"Social workers"
2010,"VA",4719,1218,45600,5937,20,"Social workers"
2016,"DC",1820,857,42000,2677,32,"Social and human service assistants"
2016,"MD",3277,490,52000,3767,13,"Social and human service assistants"
2040,"MD",3298,705,45000,4003,17,"Clergy"
2040,"VA",3760,805,28000,4565,17,"Clergy"
2100,"DC",19513,4168,113000,23681,17,"Lawyers"
2100,"MD",18439,1412,130000,19851,7,"Lawyers"
2100,"VA",28612,2958,135000,31570,9,"Lawyers"
2145,"DC",3661,1098,40000,4759,23,"Paralegals and legal assistants"
2145,"MD",4679,469,55000,5148,9,"Paralegals and legal assistants"
2145,"VA",5295,1656,40000,6951,23,"Paralegals and legal assistants"
2160,"DC",2702,54,50000,2756,1,"Miscellaneous legal support workers"
2160,"MD",2297,714,68000,3011,23,"Miscellaneous legal support workers"
2160,"VA",4785,2809,92000,7594,36,"Miscellaneous legal support workers"
2200,"DC",7552,1454,18000,9006,16,"Postsecondary teachers"
2200,"MD",12588,5970,30000,18558,32,"Postsecondary teachers"
2200,"VA",8989,5030,29500,14019,35,"Postsecondary teachers"
2300,"MD",5184,1316,17000,6500,20,"Preschool and kindergarten teachers"
2300,"VA",7379,3761,15000,11140,33,"Preschool and kindergarten teachers"
2310,"DC",6961,942,40000,7903,11,"Elementary and middle school teachers"
2310,"MD",39802,5370,48000,45172,11,"Elementary and middle school teachers"
2310,"VA",48977,5706,46500,54683,10,"Elementary and middle school teachers"
2320,"MD",5597,806,58000,6403,12,"Secondary school teachers"
2320,"VA",6449,568,50000,7017,8,"Secondary school teachers"
2330,"MD",1723,456,43000,2179,20,"Special education teachers"
2330,"VA",3343,327,44000,3670,8,"Special education teachers"
2340,"DC",3380,1345,6000,4725,28,"Other teachers and instructors"
2340,"MD",12754,2630,4500,15384,17,"Other teachers and instructors"
2340,"VA",10139,3731,6100,13870,26,"Other teachers and instructors"
2430,"MD",1534,1479,55000,3013,49,"Librarians"
2430,"VA",3074,1087,60000,4161,26,"Librarians"
2540,"DC",2865,568,10900,3433,16,"Teacher assistants"
2540,"MD",10248,2373,17000,12621,18,"Teacher assistants"
2540,"VA",9177,2600,13500,11777,22,"Teacher assistants"
2550,"MD",2461,713,25300,3174,22,"Other education, training, and library workers"
2550,"VA",2085,0,78000,2085,0,"Other education, training, and library workers"
2630,"DC",2401,1233,40000,3634,33,"Designers"
2630,"MD",5133,2105,26000,7238,29,"Designers"
2630,"VA",9130,2193,40000,11323,19,"Designers"
2710,"DC",1986,169,50000,2155,7,"Producers and directors"
2720,"DC",2177,34,3900,2211,1,"Athletes, coaches, umpires, and related workers"
2720,"MD",3767,571,4000,4338,13,"Athletes, coaches, umpires, and related workers"
2720,"VA",5713,1045,2000,6758,15,"Athletes, coaches, umpires, and related workers"
2750,"MD",2450,522,2400,2972,17,"Musicians, singers, and related workers"
2810,"DC",1359,1089,94000,2448,44,"News analysts, reporters and correspondents"
2810,"VA",1448,697,53000,2145,32,"News analysts, reporters and correspondents"
2825,"DC",2792,421,55000,3213,13,"Public relations specialists"
2825,"MD",1694,663,70000,2357,28,"Public relations specialists"
2825,"VA",4303,267,82000,4570,5,"Public relations specialists"
2830,"DC",3691,307,60000,3998,7,"Editors"
2830,"MD",4955,350,50000,5305,6,"Editors"
2830,"VA",4660,750,69000,5410,13,"Editors"
2840,"MD",2501,593,71000,3094,19,"Technical writers"
2840,"VA",2184,250,61000,2434,10,"Technical writers"
2850,"DC",3372,955,38000,4327,22,"Writers and authors"
2850,"MD",2322,110,63000,2432,4,"Writers and authors"
2850,"VA",5046,1271,50000,6317,20,"Writers and authors"
2860,"MD",2300,2075,26000,4375,47,"Miscellaneous media and communication workers"
2910,"VA",1895,281,150,2176,12,"Photographers"
3010,"MD",1310,1022,80000,2332,43,"Dentists"
3050,"MD",1929,1820,103000,3749,48,"Pharmacists"
3050,"VA",1913,1439,100000,3352,42,"Pharmacists"
3060,"DC",2458,892,87000,3350,26,"Physicians and surgeons"
3060,"MD",6492,3006,154000,9498,31,"Physicians and surgeons"
3060,"VA",5708,3133,165000,8841,35,"Physicians and surgeons"
3160,"MD",2069,744,75000,2813,26,"Physical therapists"
3160,"VA",2623,322,67000,2945,10,"Physical therapists"
3255,"DC",2165,262,51000,2427,10,"Registered nurses"
3255,"MD",21178,12047,60000,33225,36,"Registered nurses"
3255,"VA",18296,5536,55000,23832,23,"Registered nurses"
3300,"MD",2599,1445,45000,4044,35,"Clinical laboratory technologists and technicians"
3300,"VA",2150,1270,42000,3420,37,"Clinical laboratory technologists and technicians"
3320,"MD",2571,1410,60000,3981,35,"Diagnostic related technologists and technicians"
3320,"VA",1706,1023,50000,2729,37,"Diagnostic related technologists and technicians"
3420,"MD",4830,1340,27000,6170,21,"Health practitioner support technologists and technicians"
3420,"VA",4496,1621,25000,6117,26,"Health practitioner support technologists and technicians"
3500,"MD",4598,4301,39000,8899,48,"Licensed practical and licensed vocational nurses"
3500,"VA",3826,2956,30000,6782,43,"Licensed practical and licensed vocational nurses"
3510,"VA",1723,468,48000,2191,21,"Medical records and health information technicians"
3540,"VA",629,1566,52000,2195,71,"Other healthcare practitioners and technical occupations"
3600,"DC",3258,757,17000,4015,18,"Nursing, psychiatric, and home health aides"
3600,"MD",9220,10925,24000,20145,54,"Nursing, psychiatric, and home health aides"
3600,"VA",9213,7170,16000,16383,43,"Nursing, psychiatric, and home health aides"
3640,"MD",2112,555,25000,2667,20,"Dental assistants"
3640,"VA",2728,1281,24000,4009,31,"Dental assistants"
3645,"MD",3737,862,28200,4599,18,"Medical assistants"
3645,"VA",1636,1386,24000,3022,45,"Medical assistants"
3655,"MD",1459,608,24000,2067,29,"Healthcare support workers, all other, including medical equipment preparers"
3710,"VA",2248,0,100000,2248,0,"First-line supervisors of police and detectives"
3730,"MD",2483,80,50000,2563,3,"First-line supervisors of protective service workers, all other"
3730,"VA",2071,61,115000,2132,2,"First-line supervisors of protective service workers, all other"
3740,"MD",3260,0,65000,3260,0,"Firefighters"
3740,"VA",3397,60,70000,3457,1,"Firefighters"
3800,"MD",3481,551,49000,4032,13,"Bailiffs, correctional officers, and jailers"
3820,"MD",3042,130,80000,3172,4,"Detectives and criminal investigators"
3820,"VA",6283,192,102000,6475,2,"Detectives and criminal investigators"
3850,"DC",2255,0,70000,2255,0,"Police and sheriff's patrol officers"
3850,"MD",11426,180,65000,11606,1,"Police and sheriff's patrol officers"
3850,"VA",11253,810,83000,12063,6,"Police and sheriff's patrol officers"
3910,"VA",2095,63,80000,2158,2,"Private detectives and investigators"
3930,"DC",8322,202,25000,8524,2,"Security guards and gaming surveillance officers"
3930,"MD",14916,5543,40000,20459,27,"Security guards and gaming surveillance officers"
3930,"VA",12145,3964,30000,16109,24,"Security guards and gaming surveillance officers"
3955,"MD",3871,201,3000,4072,4,"Lifeguards and other recreational, and all other protective service workers"
3955,"VA",6703,361,2000,7064,5,"Lifeguards and other recreational, and all other protective service workers"
4000,"MD",2249,2710,26000,4959,54,"Chefs and head cooks"
4000,"VA",1816,5570,27000,7386,75,"Chefs and head cooks"
4010,"MD",2967,1587,18000,4554,34,"First-line supervisors of food preparation and serving workers"
4010,"VA",3914,2555,20000,6469,39,"First-line supervisors of food preparation and serving workers"
4020,"DC",5637,1935,11000,7572,25,"Cooks"
4020,"MD",13224,11663,12500,24887,46,"Cooks"
4020,"VA",13748,9974,12000,23722,42,"Cooks"
4030,"DC",2565,873,19800,3438,25,"Food preparation workers"
4030,"MD",7832,7291,12000,15123,48,"Food preparation workers"
4030,"VA",6221,7992,10000,14213,56,"Food preparation workers"
4040,"DC",2128,265,20000,2393,11,"Bartenders"
4040,"MD",2992,1436,24000,4428,32,"Bartenders"
4040,"VA",4125,1765,12000,5890,29,"Bartenders"
4050,"MD",2267,710,15000,2977,23,"Combined food preparation and serving workers, including fast food"
4050,"VA",3805,820,8400,4625,17,"Combined food preparation and serving workers, including fast food"
4060,"VA",2756,859,6000,3615,23,"Counter attendants, cafeteria, food concession, and coffee shop"
4110,"DC",4017,1527,6100,5544,27,"Waiters and waitresses"
4110,"MD",20047,6093,10000,26140,23,"Waiters and waitresses"
4110,"VA",20310,8696,11000,29006,29,"Waiters and waitresses"
4130,"MD",2924,1658,10000,4582,36,"Dining room and cafeteria attendants and bartender helpers"
4130,"VA",3043,1793,8000,4836,37,"Dining room and cafeteria attendants and bartender helpers"
4140,"MD",1410,1332,5300,2742,48,"Dishwashers"
4140,"VA",1601,1321,5700,2922,45,"Dishwashers"
4150,"MD",3951,951,2400,4902,19,"Hosts and hostesses, restaurant, lounge, and coffee shop"
4150,"VA",3618,740,2000,4358,16,"Hosts and hostesses, restaurant, lounge, and coffee shop"
4200,"MD",1471,1810,26400,3281,55,"First-line supervisors of housekeeping and janitorial workers"
4200,"VA",1772,1143,15500,2915,39,"First-line supervisors of housekeeping and janitorial workers"
4210,"MD",1707,1039,40000,2746,37,"First-line supervisors of landscaping, lawn service, and groundskeeping workers"
4220,"DC",6842,4858,15500,11700,41,"Janitors and building cleaners"
4220,"MD",15860,12765,20000,28625,44,"Janitors and building cleaners"
4220,"VA",8917,14884,18600,23801,62,"Janitors and building cleaners"
4230,"DC",2216,3081,23000,5297,58,"Maids and housekeeping cleaners"
4230,"MD",3854,22524,14000,26378,85,"Maids and housekeeping cleaners"
4230,"VA",5249,16364,13000,21613,75,"Maids and housekeeping cleaners"
4250,"MD",8678,7230,18000,15908,45,"Grounds maintenance workers"
4250,"VA",9360,6605,18000,15965,41,"Grounds maintenance workers"
4350,"MD",2708,822,11000,3530,23,"Nonfarm animal caretakers"
4350,"VA",4565,292,4500,4857,6,"Nonfarm animal caretakers"
4430,"MD",2344,444,1200,2788,15,"Miscellaneous entertainment attendants and related workers"
4430,"VA",2702,195,6000,2897,6,"Miscellaneous entertainment attendants and related workers"
4510,"MD",6780,3493,10500,10273,34,"Hairdressers, hairstylists, and cosmetologists"
4510,"VA",5043,3435,12000,8478,40,"Hairdressers, hairstylists, and cosmetologists"
4520,"MD",584,1453,15000,2037,71,"Miscellaneous personal appearance workers"
4520,"VA",1529,4401,19000,5930,74,"Miscellaneous personal appearance workers"
4600,"DC",3337,456,1800,3793,12,"Childcare workers"
4600,"MD",13579,8889,1500,22468,39,"Childcare workers"
4600,"VA",12797,10764,3500,23561,45,"Childcare workers"
4610,"MD",4794,4200,20000,8994,46,"Personal care aides"
4610,"VA",6475,5511,16000,11986,45,"Personal care aides"
4620,"DC",2036,684,9200,2720,25,"Recreation and fitness workers"
4620,"MD",8048,1104,4000,9152,12,"Recreation and fitness workers"
4620,"VA",9022,1389,4000,10411,13,"Recreation and fitness workers"
4700,"DC",2758,522,50000,3280,15,"First-line supervisors of retail sales workers"
4700,"MD",20778,6236,30000,27014,23,"First-line supervisors of retail sales workers"
4700,"VA",23157,8620,35000,31777,27,"First-line supervisors of retail sales workers"
4710,"DC",2027,669,38100,2696,24,"First-line supervisors of non-retail sales workers"
4710,"MD",7664,1174,60000,8838,13,"First-line supervisors of non-retail sales workers"
4710,"VA",9111,3616,52000,12727,28,"First-line supervisors of non-retail sales workers"
4720,"DC",5324,1053,6000,6377,16,"Cashiers"
4720,"MD",29912,11074,6000,40986,27,"Cashiers"
4720,"VA",29340,13895,6200,43235,32,"Cashiers"
4760,"DC",7589,609,9100,8198,7,"Retail salespersons"
4760,"MD",29186,7418,7200,36604,20,"Retail salespersons"
4760,"VA",34003,15848,12000,49851,31,"Retail salespersons"
4810,"MD",3489,630,45000,4119,15,"Insurance sales agents"
4810,"VA",4228,907,31000,5135,17,"Insurance sales agents"
4840,"MD",7986,781,52000,8767,8,"Sales representatives, services, all other"
4840,"VA",8547,2246,67000,10793,20,"Sales representatives, services, all other"
4850,"MD",7176,1517,60000,8693,17,"Sales representatives, wholesale and manufacturing"
4850,"VA",9206,2454,60000,11660,21,"Sales representatives, wholesale and manufacturing"
4920,"DC",2912,156,13000,3068,5,"Real estate brokers and sales agents"
4920,"MD",9419,1332,25000,10751,12,"Real estate brokers and sales agents"
4920,"VA",10115,2976,25000,13091,22,"Real estate brokers and sales agents"
4950,"VA",1685,653,2500,2338,27,"Door-to-door sales workers, news and street vendors, and related workers"
4965,"VA",3368,483,35000,3851,12,"Sales and related workers, all other"
5000,"DC",2605,474,62000,3079,15,"First-line supervisors of office and administrative support workers"
5000,"MD",17652,3461,56000,21113,16,"First-line supervisors of office and administrative support workers"
5000,"VA",17181,3684,52000,20865,17,"First-line supervisors of office and administrative support workers"
5110,"MD",4172,1207,36000,5379,22,"Billing and posting clerks "
5110,"VA",3204,1150,32000,4354,26,"Billing and posting clerks "
5120,"MD",10322,2358,35000,12680,18,"Bookkeeping, accounting, and auditing clerks"
5120,"VA",11644,2547,32000,14191,17,"Bookkeeping, accounting, and auditing clerks"
5160,"MD",2804,1056,24000,3860,27,"Tellers"
5160,"VA",1038,1136,20000,2174,52,"Tellers"
5165,"VA",2885,162,75000,3047,5,"Financial clerks, all other"
5240,"DC",5495,1078,23000,6573,16,"Customer service representatives"
5240,"MD",18104,3481,18000,21585,16,"Customer service representatives"
5240,"VA",20914,7225,18200,28139,25,"Customer service representatives"
5260,"DC",2501,228,26000,2729,8,"File clerks"
5260,"MD",4051,347,10000,4398,7,"File clerks"
5260,"VA",2231,375,10800,2606,14,"File clerks"
5300,"MD",1014,988,10800,2002,49,"Hotel, motel, and resort desk clerks"
5360,"VA",2312,178,2800,2490,7,"Human resources assistants, except payroll and timekeeping"
5400,"DC",3376,973,18700,4349,22,"Receptionists and information clerks"
5400,"MD",10560,1722,25000,12282,14,"Receptionists and information clerks"
5400,"VA",11195,3509,17000,14704,23,"Receptionists and information clerks"
5510,"MD",2542,607,25000,3149,19,"Couriers and messengers"
5520,"MD",2169,171,36000,2340,7,"Dispatchers"
5550,"MD",2503,672,50000,3175,21,"Postal service mail carriers"
5550,"VA",2802,1389,56000,4191,33,"Postal service mail carriers"
5600,"VA",3356,800,52000,4156,19,"Production, planning, and expediting clerks"
5610,"MD",2564,699,25500,3263,21,"Shipping, receiving, and traffic clerks"
5610,"VA",3249,534,25000,3783,14,"Shipping, receiving, and traffic clerks"
5620,"DC",3634,0,18000,3634,0,"Stock clerks and order fillers"
5620,"MD",12449,2970,15000,15419,19,"Stock clerks and order fillers"
5620,"VA",13414,4692,18000,18106,25,"Stock clerks and order fillers"
5700,"DC",7665,1143,11400,8808,12,"Secretaries and administrative assistants"
5700,"MD",37219,7898,34800,45117,17,"Secretaries and administrative assistants"
5700,"VA",33097,8209,32000,41306,19,"Secretaries and administrative assistants"
5810,"MD",4243,457,33000,4700,9,"Data entry keyers"
5810,"VA",1587,1110,36000,2697,41,"Data entry keyers"
5820,"MD",4137,1356,30800,5493,24,"Word processors and typists"
5820,"VA",3244,788,39000,4032,19,"Word processors and typists"
5840,"VA",2087,519,35000,2606,19,"Insurance claims and policy processing clerks"
5850,"MD",2250,35,19200,2285,1,"Mail clerks and mail machine operators, except postal service"
5860,"DC",5742,325,14400,6067,5,"Office clerks, general"
5860,"MD",13936,1734,24000,15670,11,"Office clerks, general"
5860,"VA",13124,2979,20300,16103,18,"Office clerks, general"
5940,"DC",2015,0,40000,2015,0,"Office and administrative support workers, all other"
5940,"MD",8072,2198,45000,10270,21,"Office and administrative support workers, all other"
5940,"VA",6155,1258,35100,7413,16,"Office and administrative support workers, all other"
6050,"MD",1577,777,5000,2354,33,"Miscellaneous agricultural workers "
6050,"VA",2891,1413,12000,4304,32,"Miscellaneous agricultural workers "
6200,"MD",6729,2941,50000,9670,30,"First-line supervisors of construction trades and extraction workers"
6200,"VA",6643,2257,50000,8900,25,"First-line supervisors of construction trades and extraction workers"
6220,"MD",1405,1168,29500,2573,45,"Brickmasons, blockmasons, and stonemasons"
6230,"MD",4523,13444,27100,17967,74,"Carpenters"
6230,"VA",6690,11893,25000,18583,63,"Carpenters"
6260,"DC",2220,106,12000,2326,4,"Construction laborers"
6260,"MD",7794,12135,20000,19929,60,"Construction laborers"
6260,"VA",10092,14638,24000,24730,59,"Construction laborers"
6320,"MD",2889,427,40000,3316,12,"Operating engineers and other construction equipment operators"
6320,"VA",1555,1088,43000,2643,41,"Operating engineers and other construction equipment operators"
6355,"MD",7362,1494,35000,8856,16,"Electricians"
6355,"VA",6510,1509,49000,8019,18,"Electricians"
6420,"MD",3130,7361,18000,10491,70,"Painters, construction and maintenance"
6420,"VA",2445,4559,20000,7004,65,"Painters, construction and maintenance"
6440,"MD",3968,2823,35000,6791,41,"Pipelayers, plumbers, pipefitters, and steamfitters"
6440,"VA",3111,1112,40000,4223,26,"Pipelayers, plumbers, pipefitters, and steamfitters"
6515,"MD",973,1824,12000,2797,65,"Roofers"
6515,"VA",639,2051,18000,2690,76,"Roofers"
6520,"VA",1131,1224,27000,2355,51,"Sheet metal workers"
7000,"MD",2125,135,50000,2260,5,"First-line supervisors of mechanics, installers, and repairers"
7000,"VA",1650,1349,55000,2999,44,"First-line supervisors of mechanics, installers, and repairers"
7010,"MD",2559,228,30000,2787,8,"Computer, automated teller, and office machine repairers"
7010,"VA",2121,275,48000,2396,11,"Computer, automated teller, and office machine repairers"
7020,"MD",1656,553,75000,2209,25,"Radio and telecommunications equipment installers and repairers"
7140,"VA",1580,1084,57000,2664,40,"Aircraft mechanics and service technicians"
7150,"VA",518,1899,25000,2417,78,"Automotive body and related repairers"
7200,"MD",5264,2363,38000,7627,30,"Automotive service technicians and mechanics"
7200,"VA",6562,4037,30000,10599,38,"Automotive service technicians and mechanics"
7210,"MD",1617,670,50000,2287,29,"Bus and truck mechanics and diesel engine specialists"
7315,"MD",3660,1031,50000,4691,21,"Heating, air conditioning, and refrigeration mechanics and installers"
7315,"VA",1883,1984,40000,3867,51,"Heating, air conditioning, and refrigeration mechanics and installers"
7330,"MD",1449,829,22000,2278,36,"Industrial and refractory machinery mechanics"
7340,"MD",2687,620,40000,3307,18,"Maintenance and repair workers, general"
7340,"VA",1851,581,37700,2432,23,"Maintenance and repair workers, general"
7420,"MD",2615,92,40200,2707,3,"Telecommunications line installers and repairers"
7700,"MD",3549,542,52000,4091,13,"First-line supervisors of production and operating workers"
7700,"VA",2991,941,60000,3932,23,"First-line supervisors of production and operating workers"
7750,"MD",1912,620,32000,2532,24,"Miscellaneous assemblers and fabricators"
7750,"VA",1630,786,20000,2416,32,"Miscellaneous assemblers and fabricators"
7800,"MD",825,1262,15000,2087,60,"Bakers"
7800,"VA",1125,974,16800,2099,46,"Bakers"
8140,"VA",1964,989,40000,2953,33,"Welding, soldering, and brazing workers"
8300,"MD",958,2035,2900,2993,67,"Laundry and dry-cleaning workers"
8300,"VA",832,1323,24500,2155,61,"Laundry and dry-cleaning workers"
8610,"MD",1850,175,63000,2025,8,"Stationary engineers and boiler operators"
8610,"VA",1591,1393,50000,2984,46,"Stationary engineers and boiler operators"
8740,"MD",4545,1825,22000,6370,28,"Inspectors, testers, sorters, samplers, and weighers"
8740,"VA",4364,2813,30000,7177,39,"Inspectors, testers, sorters, samplers, and weighers"
8965,"MD",2636,1287,28000,3923,32,"Production workers, all other"
8965,"VA",5533,798,25000,6331,12,"Production workers, all other"
9000,"MD",1313,1035,45000,2348,44,"Supervisors of transportation and material moving workers"
9000,"VA",1948,206,64000,2154,9,"Supervisors of transportation and material moving workers"
9030,"MD",2039,0,75000,2039,0,"Aircraft pilots and flight engineers"
9030,"VA",2492,433,110000,2925,14,"Aircraft pilots and flight engineers"
9120,"MD",8272,1527,25000,9799,15,"Bus drivers"
9120,"VA",7260,1481,28000,8741,16,"Bus drivers"
9130,"DC",1645,754,38000,2399,31,"Driver/sales workers and truck drivers"
9130,"MD",22939,6006,30000,28945,20,"Driver/sales workers and truck drivers"
9130,"VA",20488,9425,25000,29913,31,"Driver/sales workers and truck drivers"
9140,"MD",3182,5703,15000,8885,64,"Taxi drivers and chauffeurs"
9140,"VA",2353,6711,1000,9064,74,"Taxi drivers and chauffeurs"
9600,"MD",2368,66,20000,2434,2,"Industrial truck and tractor operators"
9600,"VA",2274,237,26000,2511,9,"Industrial truck and tractor operators"
9610,"MD",2802,1010,16000,3812,26,"Cleaners of vehicles and equipment"
9610,"VA",2584,656,9000,3240,20,"Cleaners of vehicles and equipment"
9620,"DC",3446,69,12000,3515,1,"Laborers and freight, stock, and material movers, hand"
9620,"MD",12012,2247,14000,14259,15,"Laborers and freight, stock, and material movers, hand"
9620,"VA",11611,5741,10000,17352,33,"Laborers and freight, stock, and material movers, hand"
9640,"MD",1413,729,20000,2142,34,"Packers and packagers, hand"
9640,"VA",1547,478,10000,2025,23,"Packers and packagers, hand"
9810,"VA",3669,94,81000,3763,2,"First-line enlisted military supervisors"
9820,"VA",3194,786,30000,3980,19,"Military enlisted tactical operations and air/weapons specialists and crew members"
9830,"MD",4177,368,50000,4545,8,"Military, rank not specified"
9830,"VA",7929,458,56000,8387,5,"Military, rank not specified"
0,0,0,0,0,0,0,0
0,0,0,0,0,0,0,0
0,0,0,0,0,0,0,0
